x12345678901234567890123456789012345678901234567890123
1RRRHHHHHHHHHHHHRHHHHHHHHHHHHHRPHHHRRHHHHHHHHHHHHRHHHH
2HHHRRHHHHHHHHHHRHHHHHHHHHHHHRPPHHRRHHHHHHHHHHHHHRHHHH
3HHHHHRRRRHHHHHHHRHHHHHHHHHHHRPPRRRPHHHHHHHHHHHHHRHHHH
4HHHHHHHHRRPHHHHRHHHHHHRRRRRRPRPPHHPPPPPPPPCPPPHRHHHHH
5HHHHHHHHHHRRHHHRHHHPRRPCCCCPPPPHHHHPPPPPPPPCPPPRPHHHH
6HHHHHHHHHHHHRRRPRRRRPCCCCCCPPHHHHHHHHHHHHPPPPPRPPPHHH
7HHHHHHHHHHHHHHRRCPPCCCCCCPPPHHHHHHHHHHHHHHPPPRCPPPPHH
8HHHHHHHHHHRRRCHPCPPPPPCCPPPHHHHHHHHHHHHHHPPPRRPPPHHHH
9HHHRHHHHRRHHHHHHPPPHPPPPPPHHHHHHHHHHHHHHPPPPRPPPHHHHH
0HRRHRRRRHHHHHHHHHPPPPPCPPPPHHHHHHHHHHHHHHPPPPRPPPHHHH
1RHHHHHHHHHHHHHHHHHHHHHPPPPHHHHHHHHHHHHHHHPPPRPPPHHHHH
2RHHHHHHHHHHHHHHPPHHHHHHPPPHHHHHHHHHHHHHHHHPPPRPHHHHHH
3HHHHHHHHHHHHHHPPPHHHHHHHPPPHHHHHHHHHHHHHHHPPRPHHHHHHH
4HHHHHHHHHHHHHHHHPPHHHHHHHPPHHHHHHHHHHHHHHHHRHHHHHHHHH
5HHHHHHHHHHHHHHHHHHPPHHHHHHPPHHHHHHHHHHHHHHRHHHHHHHHHH
6HHHHHHHHHHHHHHHHHHHHPPHHHHPPPHHHHHHHHHHHHRHHHHHHHHHHH
7HHHHHHHHHHHHHHHHHHHHHHPPPPPCCPPPPHHHHHHHHRHHHHHHHHHHH
8HHHHHHHHHHHHHHHHHHHHHHHHHHHHCRRRRRHHHHHHHHRHHHHHHHHHH
9HHHHHHHHHHHHHHHHHHHHHHHHHHHHRPPPCRHHHHHHHHRHHHHHHHHHH
0HHHHHHHHHHHHHHHHHHHHHHHHHHRRHHHHPRPPHHHHHHHRHHHHHHHHH
1HHHHHHHHHHHHHHHHHHHHRRRRRRRHHHHHHPRPHHHHHHHHRHHHHHHHH
2HHHHHHHHHHHHHHHHHHHRRHHHHHHHHHHHHPPRRRRRHHHHRHHHHHHHH
3HHHHHHHHHHHHHHHHHHRRHHHHHHHHHHHHHHHCHHPPRRRRRRHHHHHHH
4HHHHHHHHHHHHHHHHHRHHHPPPHHHHRRRRRRHRRRRRHHCCCRRRRRHHH
5HHHHHHHHHHHHHHHHHRHHHPPPPRRRPRHPPHRPPPPPPPPPPPPHPPRRR
6HHHHHHHHHHHHHHHHHRHHHRRRRPPPHHRPPPHPPHHPPPPHPPPPHHHHH
7HHHHHHHHHHHHHHHHHRRRRCCCPPHHHHRCPPPPHHHHPPHHHHHHHHHHH
8HHHHHHRRRRRHHRHHRRPPPPPPPHHHHHRPPPPPHHHHHHHHHHHHHHHHH
9HRRRRRHHHHHRRHRRHHHHHHHHHHHHHHRPPPPHHHHHHHHHHHHHHHHHH
0RRHHHHHHHHHHHHHHHHHHHHHHHHHHHRPPHHHHHHHHHHHHHHHHHHHHR
1HRHHHHHHHHHHHHHHHHHHHHHHHHHHRPPHHHHHHHHHHHHHHHHHRRRRH
2HRHHHHHHHHHHHHHHHHHHHHHHHHPRPPHHHHHHHHHHHHHHHHHRPCHHH
3HRHHHHHHHHHHHHHHHHHHHHHHHHPCRPPHHHHHHHHHHHHHHPPRPPHHH
4HRHHHHHHHHHHHHHHHHHHHHHHHHHHHRPPHHHHHHHHHHHHHPRPPHHHH
5HRCHHHHHHHHHHHHHHHHHHHHHHHHHRPPHHHHHHHHHHHHHHRPPPHHHH
6HHRCHHHHHHHHHHHHHHHHHHHHHHHRPPPHHHHHHHHHHHHHRPPPHHHHH
7HHRHHHHHHHHHHHHHHHHHHHHHHHHRPPHHHHHHHHHHHHHRPPHHHHHHH
8HHRRHHHHHHHHHHHHHHHHHHHHHHHRCPPHHHHHHHHHHHRRHHHHHHHHH
9HHHRHHHHHHHHHHHHHHHHHHHHHHRPPHHHHHHHHHHHRRHHHHHHHHHHH
0HHHHRHHHHHHHHHHHHHHHHHHHHHRRRRRHHHHHHHRRHHHHHHHHHHHHH
1HHHHHRHHHHHHHHHHHHHHHHHHHRPPPPPRRRRRRHRHHHHHHHHHHHHHH
2HHHHHRRHHHHHHHHHHHHHHHHHRPPHHHHHHCHPRRRHHHHHHHHHHHHHH
3HHHHHHHRRHHHHHHHHHHHHHHRRPPPHHHHHHHHPPRHHHHHHHHHHHRRR
4HHHHHHHHRCHHHHHHRRHRPHPRPPPPHHHHHHHHHHPRHHHPPPCRRRHHH
5HHHHHHHHHRRRRRRRRPRCRPPRPHHHHHHHHHHHHHHPRPPRRRRCHHHHH
6HHHHHHHHHHHHHHHHHHPCRPRPHHHHHHHHHHHHHHHHPRRHHHRHHHHHH
7HHHHHHHHHHHHHHHHHHHPCRPHHHHHHHHHHHHHHHHHHHHHHRHHHHHHH
8HHHHHHHHHHHHHHHHHHHHPRPHHHHHHHHHHHHHHHHHHHHHHRHHHHHHH
9HHHHHHHHHHHHHHHHHHHPRPPHHHHHHHHHHHHHHHHHHHHHRHHHHHHHH
0HHHHHHHHHHHHHHHHHHPPRPHHHHHHHHHHHHHHHHHHHHHHRPHHHHHHH
1HHHHHHHHHHHHHHHHHHPRPPHHHHHHHHHHHHHHHHHHHHHHRPHHHHHHH
2HHHHHHHHHHHHHHHHHHPRPPHHHHHHHHHHHHHHHHHHHHHRPPHHHHHHH
3HHHHHHHHHHHHHHHHHHHRHHHHHHHHHHHHHHHHHHHHHHHRHHHHHHHHH