01234567890123456789012345678901234567890123456789012
1RRRHHHHHHHHHHHHRHHHHHHHHHHHHHRPHHHRRHHHHHHHHHHHHRHHH
2HHHRRHHHHHHHHHHRHHHHHHHHHHHHRPPHHRRHHHHHHHHHHHHHRHHH
3HHHHHRRRRHHHHHHHRHHHHHHHHHHHRPPRRRPHHHHHHHHHHHHHRHHH
4HHHHHHHHRRPHHHHRHHHHHHRRRRRRPRPPHHPPPPPPPPCPPPHRHHHH
5HHHHHHHHHHRRHHHRHHHPRRPCCCCPPPPHHHHPPPPPPPPCPPPRPHHH
6HHHHHHHHHHHHRRRPRRRRPCCCCCCPPHHHHHHHHHHHHPPPPPRPPPHH
7HHHHHHHHHHHHHHRRCPPCCCCCCPPPHHHHHHHHHHHHHHPPPRCPPPPH
8HHHHHHHHHHRRRCHPCPPPPPCCPPPHHHHHHHHHHHHHHPPPRRPPPHHH
9HHHRHHHHRRHHHHHHPPPHPPPPPPHHHHHHHHHHHHHHPPPPRPPPHHHH
0HRRHRRRRHHHHHHHHHPPPPPCPPPPHHHHHHHHHHHHHHPPPPRPPPHHH
1HHHHHHHHHHHHHHHHHHHHHHPPPPHHHHHHHHHHHHHHHPPPRPPPHHHH
2RHHHHHHHHHHHHHHPPHHHHHHPPPHHHHHHHHHHHHHHHHPPPRPHHHHH
3HHHHHHHHHHHHHHPPPHHHHHHHPPPHHHHHHHHHHHHHHHPPRPHHHHHH
4HHHHHHHHHHHHHHHHPPHHHHHHHPPHHHHHHHHHHHHHHHHRHHHHHHHH
5HHHHHHHHHHHHHHHHHHPPHHHHHHPPHHHHHHHHHHHHHHRHHHHHHHHH
6HHHHHHHHHHHHHHHHHHHHPPHHHHPPPHHHHHHHHHHHHRHHHHHHHHHH
7HHHHHHHHHHHHHHHHHHHHHHPPPPPCCPPPPHHHHHHHHRHHHHHHHHHH
8HHHHHHHHHHHHHHHHHHHHHHHHHHHHCRRRRRHHHHHHHHRHHHHHHHHH
9HHHHHHHHHHHHHHHHHHHHHHHHHHHHRPPPCRHHHHHHHHRHHHHHHHHH
0HHHHHHHHHHHHHHHHHHHHHHHHHHRRHHHHPRPPHHHHHHHRHHHHHHHH
1HHHHHHHHHHHHHHHHHHHHRRRRRRRHHHHHHPRPHHHHHHHHRHHHHHHH
2HHHHHHHHHHHHHHHHHHHRRHHHHHHHHHHHHPPRRRRRHHHHRHHHHHHH
3HHHHHHHHHHHHHHHHHHRRHHHHHHHHHHHHHHHCHHPPRRRRRRHHHHHH
4HHHHHHHHHHHHHHHHHRHHHPPPHHHHRRRRRRHRRRRRHHCCCRRRRRHH
5HHHHHHHHHHHHHHHHHRHHHPPPPRRRPRHPPHHPPPPPPPPPPPPHPPRR
6HHHHHHHHHHHHHHHHHRHHHRRRRPPPHHRPPPHPPHHPPPPHPPPPHHHH
7HHHHHHHHHHHHHHHHHRRRRCCCPPHHHHRCPPPPHHHHPPHHHHHHHHHH
8HHHHHHRRRRRHHRHHRRPPPPPPPHHHHHRPPPPPHHHHHHHHHHHHHHHH
9HRRRRRHHHHHHRHRRHHHHHHHHHHHHHHRPPPPHHHHHHHHHHHHHHHHH
0RRHHHHHHHHHHHHHHHHHHHHHHHHHHHRPPHHHHHHHHHHHHHHHHHHHH
1HRHHHHHHHHHHHHHHHHHHHHHHHHHHRPPHHHHHHHHHHHHHHHHHRRRR
2HRHHHHHHHHHHHHHHHHHHHHHHHHPRPPHHHHHHHHHHHHHHHHHRPCHH
3HRHHHHHHHHHHHHHHHHHHHHHHHHPCRPPHHHHHHHHHHHHHHPPRPPHH
4HRHHHHHHHHHHHHHHHHHHHHHHHHHHHRPPHHHHHHHHHHHHHPRPPHHH
5HRCHHHHHHHHHHHHHHHHHHHHHHHHHRPPHHHHHHHHHHHHHHRPPPHHH
6HHRCHHHHHHHHHHHHHHHHHHHHHHHRPPPHHHHHHHHHHHHHRPPPHHHH
7HHRHHHHHHHHHHHHHHHHHHHHHHHHRPPHHHHHHHHHHHHHRPPHHHHHH
8HHRRHHHHHHHHHHHHHHHHHHHHHHHRCPPHHHHHHHHHHHRRHHHHHHHH
9HHHRHHHHHHHHHHHHHHHHHHHHHHRPPHHHHHHHHHHHRRHHHHHHHHHH
0HHHHRHHHHHHHHHHHHHHHHHHHHHRRRRRHHHHHHHRRHHHHHHHHHHHH
1HHHHHRHHHHHHHHHHHHHHHHHHHRPPPPPRRRRRRHRHHHHHHHHHHHHH
2HHHHHRRHHHHHHHHHHHHHHHHHRPPHHHHHHCHPRRRHHHHHHHHHHHHH
3HHHHHHHRRHHHHHHHHHHHHHHRRPPPHHHHHHHHPPRHHHHHHHHHHHRR
4HHHHHHHHRCHHHHHHRRHRPHPRPPPPHHHHHHHHHHPRHHHPPPCRRRHH
5HHHHHHHHHRRRRRRRRPRCRPPRPHHHHHHHHHHHHHHPRPPRRRRCHHHH
6HHHHHHHHHHHHHHHHHHPCRPRPHHHHHHHHHHHHHHHHPRRHHHRHHHHH
7HHHHHHHHHHHHHHHHHHHPCRPHHHHHHHHHHHHHHHHHHHHHHRHHHHHH
8HHHHHHHHHHHHHHHHHHHHPRPHHHHHHHHHHHHHHHHHHHHHHRHHHHHH
9HHHHHHHHHHHHHHHHHHHPRPPHHHHHHHHHHHHHHHHHHHHHRHHHHHHH
0HHHHHHHHHHHHHHHHHHPPRPHHHHHHHHHHHHHHHHHHHHHHRPHHHHHH
1HHHHHHHHHHHHHHHHHHPRPPHHHHHHHHHHHHHHHHHHHHHHRPHHHHHH
2HHHHHHHHHHHHHHHHHHPRPPHHHHHHHHHHHHHHHHHHHHHRPPHHHHHH
01234567890123456789012345678901234567890123456789012